0000000000000000000000000
0222222222222222222222220
0211111111111111111111120
0211111111111111111122220
0222111111111111111120000
0002222222222222222220000
0000000000000000000000000
